C   255,20 ,30
NO ./textures/akatsuki.xpm
SO ./textures/gaara.xpm
F  190,          120 , 230

EA ./textures/uchiwa.xpm

WE ./textures/uzumaki.xpm



1111    1111111111111111111111
111111111000100000000000011111
1000000000000000001110001000011
110000100000000000000000001111
100001111111000000010000111111
1111111000000000W0000000000001
11110000000000110001111000011111
10000000000000000001  100000011
11100000000001111001111000000101
  111100000000000111000000001100
111000000000111000000000001111
110000000001111000000000000111
111111111111111111111111111111
            1111
