NO ./textures/akatsuki.xpm
SO ./textures/gaara.xpm
EA ./textures/uchiwa.xpm
WE ./textures/uzumaki.xpm

F 120 ,  190,120
C 255,20 ,30














1111    1111111111111111111111
111111111000100000000000011111
1000000000000000001110001000011
110000100000000000000000001111
100001111111000000010000111111
1111111000000000W0000000000011
1111000000000011111111011111
100000000000001       1000001 
11100000000011111111100000011
  1111000000000001110000000011
111000000000111000000000001111
110000000001111000000000000111
111111111111111111111111111111
            1111
