
NO ./textures/akatsuki.xpm
SO ./textures/gaara.xpm
EA ./textures/uchiwa.xpm
WE ./textures/uzumaki.xpm

F 220 , 100  , 0
C 225 ,  30  , 0

1111111111111        1111111111111111
10000000000001       11010000000000001
1000000000001        1010N00100111111
100000000000111111111100000010011    
 1000000000001       11000000000111
1111111111111        1111111111111111
