
NO ./textures/akatsuki.xpm
SO ./textures/gaara.xpm
WE ./textures/uzumaki.xpm

F 220 , 100  , 0
C 225 ,  30  , 0

EA ./textures/uchiwa.xpm
1111111111111        1111111111111111
 1000000000001       11000000000111
1111111111111        1111111111111111
