
NO ./textures/akatsuki.xpm
SO ./textures/gaara.xpm
EA ./textures/uchiwa.xpm
WE ./textures/uzumaki.xpm

F 220 , 100  , 0
C 225 ,  30  , 0

1111111111111        1111111111111111
1000000000001        1010000000000001
1000000000001        1010N00100000111
1000000000001111111111000000100
1000000000001        1000000000010001
1111111111111        1111111111111111