NO ./img/bark.xpm
SO ./img/bricks.xpm
WE ./img/coal.xpm
EA ./img/planks.xpm

F 45,64,73
C 135,206,235

        1111111111111111111111111
        1000000000110000000000001
        1011000001110000000000001
        1001000000000000000000001
111111111011000001110000000000001
100000000011000001110111111111111
1111011111111101000000100001
1111011111111101010100100001
11000000110101011100000010001
10000000000000001100000000001
10000000000000001101010010001
11000001110101011111011110N0111
11110111 1110101 101111010001
11111111 1111111 111111111111
